11111111111111
110E00P0C00C11
11111111111111
