1111111111111111111111111111111111
1P000000E00100000000000000000N0001
10000000C000000C0000000000000N0001
10000000C00000100011C0000000000001
1000C0000C00000000001000C000000001
100000N00C00N0000000000C0000000001
1111111111111111111111111111111111